1111111
1P000C0
10000E1
1111111