1111111111111111
1P0000X000000001
100000000C000001
10000000000000E1
1111111111111111