1111111
10000C1
10000E1
1111111