1111111111
1000P00C01
1000000001
10000001E1
1111111111
