11111111
1P0000C1
10000111
100001E1
11111111