1111111
1P000C1111
10000E1111
1111111