11111111
1P0001C1
10000111
100000E1
11111111