111111111111111111111111111111111111111111111111111111111
1P00000000000000000000000000000C00000000000000000C0000001
10000000000111111111111111110000000000000000C000000000001
100000000000000000000000000000000001110000000000000000001
11111000C000000000000000000000000000000000000000000000001
100000000000000000000000000000000000000000000000001111111
100000000000000000000000000000000000000110000000000000001
1C00000000000000000000C1100000000000000000000000000000001
100000000000000000000000000000000000000000000000000000001
10000000000000000000000000000000000C000000000000000000001
1000000000000001111111111111111000000000000000000000000E1
1000000000000C0000000000000000C11111111111000000000000001
100000000000000000000000000000011111111111000000000000001
100000000000000000000000000000000000000000000000001111111
1111111000000000000000000000000000000000C0000000000000001
111100000000000000000000000000000000000000000000000000001
111111111111111111111111111111111111111111111111111111111