111111111111111111111111111111111111111111111111111111111111111111111111
1P00000000000000000000000000000C00000000000000000C0000000001111111111111
10000000000111111111111111110000000000000000C000000000000000000000000001
100000000000000000000000000000000001110000000000000000000000000000000001
11111000C00000000000000000000000000000000000000000000000000000000000C001
100000000000000000000000000000000000000000000000001111111000000000001111
100000000000000000000000000000000000000110000000000000000000000000000001
1C00000000000000000000C1100000000000000000000000000000000000000000000001
100000000000000000000000000000000000000000000000000000000000000000000001
10000000000000000000000000000000000C000000000000000000000000000000000001
1000000000000000000000000000000000000000000000000000000000000000000000E1
111111111111111111111111111111111111111111111111111111111111111111111111