1111111111
1P00000C01
1000000001
10000000E1
1111111111
